R 1080 720
NO ./textures/eagle.xpm
EA ./textures/colorstone.xpm
WE ./textures/redbrick.xpm
SO ./textures/purple.xpm
S ./textures/barrel.xpm
C 0,0,1
F 255,0,200
FT ./textures/greystone.xpm
CT ./textures/wood.xpm
        1111111111111111111111111
        1000000000110000000000001
        1011000001110000002000001
        1001000000000000000000001
111111111011000001110000000000001
100000000011000001110111111111111
11110111111111011100000010001
11110111111111011101010010001
11000000110101011100000000001
10002000000000001100000N10001
10000000000000001101010010001
11000001110101011111011110001
11110111 1110101 101111010001
11111111 1111111 111111111111
